#############################
#     #     #       #      B#
# ### # ### # ### ### ### ###
# #   # #       #     #     #
# # ### # ########### ##### #
# #     #     #     #     # #
# ##### ##### ### # ##### # #
#     #     #     #     #   #
##### ### ##### ### ### #####
#   #   #     #       #     #
### ### ##### ### ### # ### #
#     # #     #   #   # #   #
# ### # # ##### ### ### # ###
#   # # #   #     #   # #   #
### # # ### ### ### # ##### #
#   # #     # #   # #     # #
# ##### ### # # ### ##### # #
#     # #   # #   #   #   # #
##### # # ### ### ### # ### #
#     # #     #   #   #     #
# ### ##### ### ### ####### #
#   #           #         #A#
#############################